10 10 1.5 1.5 0
##########
#____#___#
###_###_##
#___#__#_#
#_#_#__#_#
###_##___#
#____#_#_#
#______#_#
#____#_#_#
##########